a.m.	AM
am 	AM
am.	AM
Am	AM
A M	AM
atm 	ATM
Atm	ATM
A T M	ATM
B2B	B to B
c b a	CBA
cba	CBA
CBA	CBA
cctv	CCTV
C C t v	CCTV
CD	C D
c e o	CEO
ceo	CEO
C E O	CEO
cpu	CPU
C P U	CPU
d v	DV
dv	DV
D V	DV
EQ	EQ
f i f a	fifa
F I F A	fifa
FIFA	fifa
gps	GPS
G P S	GPS
gpu	GPU
GPU	GPU
iq	IQ
IQ	IQ
kfc	KFC
K F C	KFC
m b a	MBA
mba	MBA
M B A	MBA
ms	MS
m v	MV
mv	MV
MV	MV
mvp	MVP
M V P	MVP
M.V.P	MVP
n b a	NBA
nba	NBA
Nba	NBA
NBA	NBA
O 2 O	O to O
O2O	O to O
P 2 P	P to P
P2P	P to P
p c	PC
pc	PC
P C	PC
p.m.	PM
pm 	PM
pm.	PM
Pm	PM
qq	QQ
Qq	QQ
Q Q	QQ
Steam	steam
u f o	UFO
ufo	UFO
Ufo	UFO
U F O	UFO
vip	VIP
V I P	VIP
WIFI	wifi
w t o 	WTO
wto	WTO
W T O	WTO
x L	XL
X L	XL
x x L	XXL
X X L	XXL
x x x L	XXXL
X X X L	XXXL
